11111111111111
1000C0000C00E1
11111100C00001
1000C010C00001
10C00C00C00001
11111111111001
100C0000001101
10111100001001
10000100001001
1P00010000C001
11111111111111
