1111111111111111
1000010001E00001
1011010101111101
1PC100C100000001
1111111111111111
